工	aaa
匿	aad
芽	aah
戒	aak
盞	aal
戔	aau
式	aay
荫	abe
茸	abf
邛	abh
蒸	abi
节	abj
藬	abk
茁	abm
艿	abr
萨	abu
匜	abv
茎	aca
芭	acb
苔	ack
茅	acn
戎	ade
苦	adf
荐	adh
藉	adi
若	adk
项	adm
藏	adn
芖	adu
基	adw
茂	adx
莽	ady
荔	aee
薶	aej
茄	aek
藐	aer
菜	aes
功	aet
藤	aeu
苏	aew
邯	afb
芸	afc
甘	afd
芏	aff
蒜	afi
芉	afj
蕾	afl
贰	afm
苇	afn
荸	afp
芜	afq
某	afs
著	aft
蔷	afu
芙	afw
荆	aga
荎	agc
匡	agd
莆	age
芋	agf
廿	agh
蕙	agj
七	agn
莱	ago
葬	agq
茉	ags
苹	agu
菲	ahd
芷	ahf
熙	ahk
卧	ahn
牙	aht
范	aib
薄	aig
菠	aih
东	aii
藻	aik
薀	ail
荡	ain
菏	ais
落	ait
汞	aiu
茫	aiy
莫	ajd
萌	aje
昔	ajf
划	ajh
菖	ajj
蔓	ajl
葛	ajq
蓝	ajt
茧	aju
郾	ajv
叵	akd
革	akf
勤	akg
匮	akh
颧	akk
燕	aku
蔑	ald
苗	alf
莗	alj
匣	alk
莲	alp
萝	alq
菌	alt
英	amd
苖	amf
匝	amh
贡	amu
黄	amw
艺	anb
巨	and
蔚	anf
昂	ang
蔬	anh
蕊	ann
芯	anu
世	anv
蔗	aoa
菧	aoq
蘑	aos
苂	aou
劳	ape
蒙	apf
莹	apg
萤	apj
营	apk
荤	apl
荧	apo
莺	apq
荣	aps
芝	apu
蓉	apw
苑	aqb
菳	aqf
葡	aqg
荀	aqj
敬	aqk
苞	aqn
菊	aqo
葱	aqr
获	aqt
芕	aqu
匹	aqv
芍	aqy
葩	arc
苩	arf
瓯	arg
区	ari
芹	arj
匠	ark
欧	arq
艾	aru
殴	arw
茜	asf
苯	asg
艼	asj
苛	ask
㭉	asu
葽	asv
苌	ata
莠	atb
医	atd
董	atg
莉	atj
蓖	atl
薇	atm
蕃	ato
䒘	atu
萎	atv
莓	atx
攻	aty
菛	auf
菩	auk
蔽	aum
茨	auq
薪	aus
蒹	auv
蔺	auw
艽	avb
蔇	avc
菇	avd
萧	avi
茹	avk
菑	avl
芀	avr
切	avt
苍	awb
茯	awd
蔡	awf
葵	awg
芥	awj
恭	awn
茶	aws
共	awu
芬	awv
巫	aww
花	awx
恐	awy
芎	axb
苐	axh
蕴	axj
药	axq
苺	axu
䓂	ayf
弋	ayi
蔼	ayj
蓑	ayk
荒	ayn
芳	ayr
蒂	ayu
萃	ayw
蓄	ayx
陈	bai
半	ban
包	bao
聀	bay
子	bbb
孕	bbf
孖	bbg
耶	bbh
阤	bbn
聂	bcc
聚	bci
孡	bck
盈	bcl
娶	bcv
取	bcy
隋	bda
呄	bdf
阫	bdh
承	bdi
陌	bdj
陇	bdx
阴	beg
被	bei
本	ben
聣	beq
阞	bet
隠	bev
孺	bfd
陡	bfh
际	bfi
阱	bfj
聐	bfk
隯	bfn
阮	bfq
陼	bft
陵	bfw
陆	bgb
卫	bgd
耳	bgh
隔	bgk
陋	bgm
陕	bgu
陘	bgv
芔	bhb
陂	bhc
耻	bhg
陟	bhh
屮	bhk
鼐	bhn
㞣	bhw
函	bib
别	bie
丞	big
氶	bii
隙	bij
㞼	bim
斌	bin
逊	bip
尕	biu
孙	biy
阳	bjg
刵	bjh
隅	bjm
亟	bkc
叾	bkf
聩	bkh
陨	bkm
职	bkw
孟	blf
䧃	blg
阵	blh
祟	bmf
聘	bmg
出	bmk
孭	bmy
了	bnh
孔	bnn
乃	bnt
孞	bnu
恥	bny
䧪	bod
䧤	bog
䧜	bov
耿	boy
䢊	bpd
辸	bpe
院	bpf
聢	bpg
辽	bpk
耽	bpq
迆	bpv
陀	bpx
陷	bqe
孢	bqn
陱	bqo
陶	bqr
聊	bqt
隐	bqv
孤	brc
隍	brg
䧈	bsg
耵	bsh
阿	bsk
朶	bsu
降	bta
聒	btd
陲	btf
隆	btg
阼	bth
孜	bty
联	bud
隧	bue
障	buj
聪	buk
隘	buw
限	bve
孻	bvh
聬	bwc
附	bwf
除	bwg
阶	bwj
队	bwy
乸	bxi
陛	bxx
及	byi
聤	byk
孩	byn
防	byt
颈	cad
劲	cae
才	cai
弁	caj
残	can
草	cao
迳	cap
戏	cay
邓	cbh
又	ccc
斚	ccp
㕕	ccu
双	ccy
叁	cdd
参	cde
畚	cdl
䏍	cef
通	ceh
岑	cen
劝	cet
能	cex
圣	cff
怼	cfn
对	cfy
驱	cga
骤	cgb
骚	cgc
马	cgd
骊	cgg
驶	cgk
骡	cgl
骋	cgm
驼	cgp
驹	cgq
驳	cgr
骄	cgt
骥	cgu
验	cgw
骗	cgy
差	cha
车	che
吃	chi
冲	cho
覌	chq
出	chu
厼	ciu
邰	ckb
台	ckf
怠	ckn
迨	ckp
㰧	ckq
巼	ckx
岊	cmj
观	cmq
贠	cmu
预	cnh
厶	cny
驟	cob
騃	coc
騎	cod
驍	cof
驪	cog
驢	coh
馬	coi
馹	coj
駛	cok
驛	col
騧	com
从	con
駁	cor
驃	cos
驕	cot
凑	cou
騄	cov
騟	cow
騙	coy
允	cqb
欢	cqw
鸡	cqy
矣	ctd
牟	ctg
催	cui
村	cun
错	cuo
艰	cve
逡	cwt
难	cwy
叉	cyi
蚤	cyj
厮	dad
左	daf
矼	dag
礴	dai
㚏	daj
砸	dam
碟	dan
到	dao
礞	dap
砌	dav
䂝	day
顾	dbd
耷	dbf
矷	dbg
䂙	dbh
㚎	dbj
础	dbm
厄	dbv
夿	dcb
鬃	dce
码	dcg
镻	dcr
友	dcu
肆	dcv
雄	dcw
套	ddc
磊	ddd
碱	ddg
厦	ddh
硕	ddm
㚐	ddu
厌	ddy
郁	deb
历	dee
有	def
胡	deg
得	dei
扽	den
夯	der
劯	det
長	deu
奔	dfa
磕	dfc
圧	dfd
辱	dfe
奎	dff
矸	dfh
奈	dfi
夲	dfj
厈	dfk
夸	dfn
奢	dft
夺	dfu
压	dfy
研	dga
三	dgg
古	dgh
硬	dgj
感	dgk
厉	dgq
厂	dgt
砰	dgu
威	dgv
戌	dgx
存	dhb
破	dhc
慧	dhd
甭	dhe
在	dhf
歪	dhg
不	dhi
丰	dhk
还	dhp
艳	dhq
夏	dht
契	dhv
嗲	dia
耙	dic
硝	die
耕	dif
耒	dii
定	din
砂	dit
泵	diu
耪	diy
厚	djb
百	djf
碍	djg
砷	djh
夰	djj
奄	djn
右	dkf
夼	dkj
奋	dlf
砗	dlh
厍	dlk
䃛	dlp
硱	dls
碘	dma
冇	dmb
碳	dmd
碉	dmf
布	dmh
而	dmj
砚	dmq
页	dmu
碾	dna
乭	dnb
臧	dnd
䎁	dng
嘏	dnh
尴	dnj
怘	dnu
尢	dnv
尬	dnw
盛	dnx
尤	dny
盔	dol
懂	don
磷	doq
矿	dot
灰	dou
达	dpi
碗	dpq
牵	dpt
砥	dqa
克	dqb
兢	dqd
确	dqe
碒	dqg
㚚	dqk
砍	dqw
矽	dqy
砶	drg
斫	drh
愿	dri
磈	drq
爽	drr
碑	drt
硒	dsg
厢	dsh
碴	dsj
厅	dsk
㚓	dsu
邦	dtb
寿	dtf
硌	dtk
砾	dtn
砭	dtp
故	dty
厥	dub
㕇	dud
辜	duf
砬	dug
对	dui
碚	duk
顿	dun
碰	duo
冭	duu
磁	dux
厩	dvc
砕	dvf
硉	dvg
碌	dvi
䃳	dvl
舂	dwe
奏	dwg
仄	dwi
春	dwj
矶	dwn
秦	dwt
雁	dww
礁	dwy
㔫	dxb
䂗	dxn
砒	dxx
袭	dxy
硫	dyc
砫	dyg
丈	dyi
礅	dyk
态	dyn
磅	dyu
碎	dyw
戍	dyx
砇	dyy
腻	eaf
肛	eag
舁	eaj
貓	eal
朦	eap
㥯	eav
毁	eaw
服	ebc
孚	ebf
䏪	ebg
乳	ebn
胫	eca
蜰	ecj
胎	eck
肥	ecn
肱	edc
胯	edf
胚	edh
须	edm
胧	edx
肽	edy
月	eee
舀	eef
朋	eeg
鹏	eeq
肋	eet
胁	eew
肢	efc
肚	efg
肝	efh
膨	efk
腩	efm
脖	efp
豺	eft
寽	efu
膤	efv
肤	efw
肘	efy
县	egc
且	egd
助	ege
膈	egk
肺	egm
與	egn
脛	egv
胰	egx
叟	ehc
腓	ehd
用	ehk
胪	ehn
辵	ehu
胱	eig
盥	eil
䐝	eim
膛	eip
膌	eiw
㸓	ejf
胆	ejg
刖	ejh
腢	ejm
腥	ejt
驾	ekc
加	ekg
肿	ekh
臊	ekk
贺	ekm
迦	ekp
架	eks
袈	eky
胭	eld
舅	ele
舆	elg
胛	elh
腮	eln
臅	elq
爵	elv
腆	ema
貒	emd
爯	emf
胴	emg
帠	emh
腡	emn
觅	emq
㐍	enb
鞥	eng
貑	enh
䑀	enk
肊	enn
肠	enr
力	ent
鼠	enu
甩	env
脏	eof
臕	eon
䊆	eou
膅	eov
腑	eow
脒	eoy
受	epc
爱	epd
边	epe
腚	epg
腕	epq
胺	epv
腔	epw
兒	eqb
脃	eqc
脆	eqd
胞	eqn
舄	eqo
胸	eqr
豹	eqy
胉	erg
肵	erh
腺	eri
遥	erm
貌	erq
脾	ert
䑈	erx
彩	ese
膘	esf
采	esu
腰	esv
膝	esw
䝗	esy
胀	eta
胜	etg
臼	eth
腹	etj
胳	etk
貔	etl
腇	etv
腾	eud
胖	eug
臆	euj
脱	euk
䐚	evc
腿	eve
妥	evf
肗	evg
貂	evk
肍	evn
㼏	evr
肕	evy
股	ewc
脸	ewg
办	ewi
肌	ewn
貅	ews
奚	exd
䏖	exh
脂	exj
膙	exk
肶	exx
胟	exy
脐	eyj
膻	eyl
脉	eyn
脑	eyr
肪	eyt
膀	eyu
朖	eyv
胶	eyw
臃	eyx
堪	fad
卋	faf
卉	faj
霸	fak
饭	fan
塔	faw
邗	fbh
壭	fbj
凷	fbk
地	fbn
圾	fby
却	fcb
动	fce
翅	fcn
运	fcp
魂	fcr
埃	fct
去	fcu
雳	fde
震	fdf
坧	fdg
坏	fdh
需	fdm
城	fdn
坥	feg
飞	fei
分	fen
霓	feq
霢	fer
㔹	fet
协	few
坛	ffc
圭	fff
填	ffh
款	ffi
恚	ffn
堵	fft
寺	ffu
博	fge
二	fgg
十	fgh
垣	fgj
坪	fgu
墟	fha
趣	fhb
坡	fhc
霏	fhd
趄	fhe
直	fhf
址	fhg
赴	fhh
趟	fhi
盐	fhl
武	fhn
趋	fhq
赵	fhr
走	fhu
超	fhv
真	fhw
圤	fhy
霄	fie
霈	fig
未	fii
示	fiu
朝	fjf
坦	fjg
刊	fjh
亓	fjj
井	fjk
塌	fjn
进	fjp
埸	fjq
颉	fkd
袁	fke
吉	fkf
圳	fkh
鼓	fku
哉	fkx
戴	fla
雷	flf
夁	fll
载	flx
圸	fmh
献	fmu
坝	fmy
㐋	fnb
䨒	fnf
霞	fnh
霹	fnk
圮	fnn
声	fnr
志	fnu
亏	fnv
块	fnw
专	fny
郝	fob
垿	foc
赫	fof
覝	foh
圹	fot
赤	fou
塘	fov
勃	fpb
壹	fpg
过	fpi
辻	fpk
毂	fpl
壶	fpo
壳	fpw
索	fpx
元	fqb
顽	fqd
雹	fqn
远	fqp
均	fqu
无	fqv
坎	fqw
坂	frc
垢	frg
圻	frh
塊	frq
霜	fsh
墰	fsj
坷	fsk
霖	fss
雬	fsu
栽	fsx
教	ftb
才	fte
霆	ftf
考	ftg
者	ftj
圪	ftn
老	ftx
坆	fty
丧	fue
幸	fuf
垃	fug
境	fuj
培	fuk
增	ful
霎	fuv
垠	fve
雪	fvf
壗	fvh
替	fwf
夫	fwi
堢	fwk
规	fwm
埠	fwn
垛	fws
赍	fww
墢	fwx
零	fwy
䨎	fxc
塡	fxh
㘭	fxn
堦	fxx
坶	fxy
堉	fyc
裁	fye
霅	fyf
圡	fyi
霭	fyj
壤	fyk
壈	fyl
塆	fyo
雱	fyr
坊	fyt
雯	fyu
坑	fyw
坟	fyy
邢	gab
琪	gad
形	gae
玒	gag
该	gai
弄	gaj
开	gak
瑛	gam
干	gan
高	gao
璥	gaq
㻓	gbc
珥	gbg
击	gbj
顿	gbn
至	gcf
玛	gcg
丟	gcu
㺨	gcy
瑚	gde
环	gdh
天	gdi
蚕	gdj
吞	gdk
顼	gdm
琦	gds
㺯	gdu
珑	gdx
青	gef
玥	geg
甫	geh
豕	gei
珈	gek
靓	gem
跟	gen
逐	gep
静	geq
瑶	ger
玏	get
表	geu
珐	gfc
珪	gff
玕	gfh
于	gfk
盂	gfl
玮	gfn
迂	gfp
玩	gfq
琶	ggc
琢	gge
王	ggg
五	ggh
球	ggi
一	ggl
瑟	ggn
琴	ggw
琵	ggx
珏	ggy
琥	gha
玻	ghc
正	ghd
焉	ghg
下	ghi
玷	ghk
丐	ghn
璨	ghq
政	ght
㺪	ghy
琐	gim
救	giy
理	gjf
亘	gjg
惠	gjh
丌	gjk
更	gjr
琨	gjx
璟	gjy
吾	gkf
囊	gkh
整	gki
卅	gkk
副	gkl
融	gkm
带	gkp
吏	gkr
豆	gku
事	gkv
画	glb
玾	glh
柬	gli
卌	glk
琏	glp
㻿	glq
遭	gma
瑞	gmd
再	gmf
刺	gmi
珊	gmm
现	gmq
责	gmu
两	gmw
丽	gmy
珉	gna
㐏	gnb
琚	gnd
与	gng
瑕	gnh
㝳	gni
瑋	gnk
瓦	gnn
戸	gnr
忢	gnu
丂	gnv
严	god
亚	gog
灭	goi
共	gon
琰	goo
够	gou
瑭	gov
迋	gpd
琮	gpf
珲	gpl
琬	gpq
琛	gpw
殆	gqc
万	gqe
残	gqf
琻	gqg
歹	gqi
列	gqj
殃	gqm
迈	gqp
殉	gqq
殊	gqr
熬	gqt
殚	gqu
兀	gqv
殓	gqw
死	gqx
玖	gqy
碧	grd
珀	grg
珠	gri
瑰	grq
瓆	grr
璬	gry
玎	gsh
末	gsi
亍	gsj
珂	gsk
琳	gss
琇	gtb
瓒	gtf
珩	gtg
珞	gtk
璁	gtl
麦	gtu
㻶	gtv
玫	gty
挂	gua
夹	gud
平	guf
贵	gui
璋	guj
璔	gul
滚	gun
过	guo
珢	gve
妻	gvh
琭	gvi
璅	gvj
玿	gvk
㻏	gvo
瑙	gvt
玳	gwa
玜	gwc
珍	gwe
瑜	gwg
玑	gwn
兲	gwu
玲	gwy
互	gxg
纛	gxh
素	gxi
毒	gxu
夷	gxw
瑎	gxx
琉	gyc
斑	gyg
玉	gyi
琼	gyk
璃	gyr
班	gyt
琅	gyv
玟	gyy
虐	haa
虏	hae
瞒	hag
还	hai
虞	hak
瞄	hal
虑	han
虚	hao
虍	hav
虎	haw
虔	hay
䶔	hbb
䶕	hbc
䶢	hbd
䶧	hbf
眲	hbg
䶥	hbh
齒	hbj
䶫	hbk
䁅	hbl
䶤	hbm
齷	hbn
齳	hbp
䶟	hbq
齗	hbr
䶗	hbs
䶜	hbt
䶘	hbu
齦	hbv
䶖	hbw
齔	hbx
齩	hby
㿬	hcc
颇	hcd
皯	hcf
皮	hci
眙	hck
眸	hct
攴	hcu
㿳	hcv
睚	hdf
䀦	hdg
辈	hdh
瞭	hdu
眬	hdx
肯	hef
眀	heg
瞍	heh
黑	hei
䂃	hel
很	hen
瞬	hep
睨	heq
睬	hes
䀐	het
睜	hev
歧	hfc
眭	hff
盰	hfh
眛	hfi
睹	hft
䁄	hfu
睦	hfw
盹	hgb
上	hgd
睛	hge
卡	hgh
叔	hgi
睫	hgv
频	hhd
止	hhg
目	hhh
丨	hhl
睍	hhq
步	hhr
歨	hhu
瞿	hhw
卜	hhy
瞠	hip
卓	hjf
旧	hjg
䁙	hjp
桌	hjs
战	hka
占	hkf
点	hko
盀	hlf
睤	hlg
卤	hlr
睏	hls
瞜	hlv
㮚	hlw
眏	hmd
睭	hmf
卣	hmn
遉	hmp
贞	hmu
眠	hna
瞰	hnb
鼎	hnd
凹	hnm
䁕	hnn
卢	hnr
瞩	hnt
歯	hob
瞨	hog
红	hon
瞇	hop
瞵	hoq
后	hou
䁖	hov
眯	hoy
瞎	hpd
肻	hpe
睆	hpf
睿	hpg
瞑	hpj
眈	hpq
㢟	hpv
見	hqb
餐	hqc
瞻	hqd
䙷	hqf
眺	hqi
睌	hqk
䁩	hqo
歺	hqu
睁	hqv
䁓	hrb
眅	hrc
盺	hrh
瞴	hrl
矈	hrp
䀿	hrr
睥	hrt
䁻	hrx
䁶	hry
瞟	hsf
盯	hsh
瞫	hsj
㱒	hsk
䁏	hsv
睡	htf
矀	htm
盵	htn
瞅	hto
眨	htp
䀲	htx
话	hua
䀞	huf
会	hui
瞳	huj
䁬	hul
混	hun
或	huo
䁠	huv
睇	hux
眼	hve
龄	hwb
瞈	hwc
瞪	hwg
睺	hwn
具	hwu
盼	hwv
瞧	hwy
砦	hxd
些	hxf
赀	hxm
此	hxn
柴	hxs
姕	hxv
雌	hxw
紫	hxx
訾	hxy
瞮	hyc
瞓	hyk
䁴	hyl
睙	hyn
眆	hyt
䁤	hyu
䀶	hyv
睟	hyw
眩	hyx
盿	hyy
湛	iad
江	iag
漠	iaj
灌	iak
汇	ian
涝	iap
鸿	iaq
沤	iar
柒	ias
浇	iat
沏	iav
洪	iaw
㳀	iay
滠	ibc
洱	ibg
涵	ibi
㳱	ibj
凼	ibk
池	ibn
漋	ibt
滁	ibw
㶌	ibx
汲	iby
泾	ica
渗	icd
涌	ice
泽	icg
治	ick
沇	icq
滩	icw
汉	icy
汯	idc
湖	ide
涯	idf
沽	idg
沣	idh
淹	idj
湎	idm
㳠	idp
源	idr
涛	idt
尖	idu
汰	idy
浮	ieb
滔	iee
肖	ief
沮	ieg
削	iej
逍	iep
淫	iet
溪	iex
灞	ifa
法	ifc
尘	iff
汢	ifg
汗	ifh
潮	ifj
洁	ifk
污	ifn
渤	ifp
渚	ift
潜	ifw
浅	ifx
沌	igb
添	igd
清	ige
汪	igg
沔	igh
洹	igj
滞	igk
沛	igm
涞	igo
耀	igq
沫	igs
浃	igu
举	igw
滤	iha
波	ihc
泪	ihg
涉	ihh
渺	ihi
淖	ihj
沾	ihk
泸	ihn
瀣	ihq
小	iht
濉	ihw
消	iie
淼	iii
淌	iim
沙	iit
沝	iiy
瀑	ija
沓	ijf
汨	ijg
漫	ijl
湿	ijo
渴	ijq
滥	ijt
混	ijx
浊	ijy
湒	ikb
浥	ikc
涓	ike
呇	ikf
汌	ikh
渑	ikj
澡	ikk
涡	ikm
㳏	ikr
㳭	iks
㕾	ikx
潩	ila
涸	ild
渭	ile
畄	ilf
泗	ilg
㳌	ilh
単	ilj
洄	ilk
㵋	ilm
潿	iln
涟	ilp
濁	ilq
渐	ilr
涃	ils
漊	ilv
泅	ilw
漯	ilx
澧	ima
湍	imd
滑	ime
溅	imf
油	img
汕	imh
测	imj
尚	imk
涔	imw
浿	imy
泯	ina
潺	inb
漏	inf
渥	ing
湄	inh
涮	inm
汜	inn
汤	inr
泼	int
泥	inx
沁	iny
渡	ioa
瀍	ioj
漉	ion
淡	ioo
㲿	iot
濂	iou
溏	iov
洣	ioy
学	ipb
浓	ipe
尝	ipf
演	ipg
涫	iph
溟	ipj
党	ipk
浑	ipl
觉	ipm
沈	ipq
滨	ipr
泞	ips
滓	ipu
深	ipw
沱	ipx
沟	iqc
澹	iqd
淦	iqg
洵	iqj
涣	iqm
泡	iqn
淘	iqr
漪	iqt
汐	iqy
汹	irb
淆	ird
派	ire
泊	irg
沂	irh
汽	irn
浙	irr
激	iry
漂	isf
洒	isg
汀	ish
潭	isj
河	isk
淅	isr
淋	iss
漆	isw
沐	isy
活	itd
少	ite
浩	itf
省	ith
洛	itk
澳	itm
潘	ito
泛	itp
涤	its
海	itx
汷	ity
溯	iub
㶒	iuc
泣	iug
涧	iuj
涪	iuk
潎	ium
溢	iuw
滋	iux
溉	ivc
当	ivf
汝	ivg
沼	ivk
淄	ivl
氿	ivn
浸	ivp
染	ivs
梁	ivw
涩	ivy
沧	iwb
没	iwc
脊	iwe
浍	iwf
涂	iwg
沿	iwk
㲹	iwn
濮	iwo
氼	iwu
汾	iwv
浴	iww
沦	iwx
淮	iwy
泓	ixc
澠	ixg
沸	ixj
涨	ixt
溺	ixu
潍	ixw
沘	ixx
流	iyc
注	iyg
济	iyj
淳	iyk
沪	iyn
湾	iyo
漓	iyr
洲	iyt
滴	iyu
浪	iyv
液	iyw
汶	iyy
蟒	jad
虹	jag
蚜	jah
蜡	jaj
蝶	jan
晓	jat
暴	jaw
最	jbc
㫗	jbf
虸	jbg
蜢	jbl
虵	jbn
蝃	jcc
肾	jce
坚	jcf
蚂	jcg
贤	jcm
蚆	jcn
竖	jcu
紧	jcx
蛂	jdc
蝴	jde
晨	jdf
蛄	jdg
蚌	jdh
蝒	jdm
晟	jdn
旲	jdu
冐	jef
明	jeg
盟	jel
暧	jep
㫑	jet
野	jfc
里	jfd
蛙	jff
旰	jfh
昧	jfi
早	jfj
蝻	jfm
暑	jft
时	jfy
蛭	jgc
昊	jgd
晴	jge
旦	jgf
旺	jgg
题	jgh
量	jgj
晤	jgk
暕	jgl
师	jgm
㫵	jhd
冒	jhf
刂	jhh
申	jhk
虫	jhn
虲	jhy
家	jia
届	jie
晃	jig
㫾	jim
烬	jin
螳	jip
就	jiu
曝	jja
昌	jjf
昍	jjg
晶	jjj
蝹	jjl
蝎	jjq
䖵	jjy
蜈	jkg
蚛	jkh
蝇	jkj
蟬	jkk
蜗	jkm
㫛	jkq
曼	jlc
蝟	jle
蛊	jlf
蝈	jlg
蛼	jlh
蛔	jlk
蠝	jll
螹	jlr
蜠	jlt
螺	jlx
映	jmd
蚰	jmg
愚	jmh
旵	jmj
蛽	jmy
蛡	jng
暇	jnh
虬	jnn
遢	jnp
电	jnv
昵	jnx
昿	joc
显	jog
蠑	joo
旷	jot
炅	jou
炚	joy
暄	jpg
螟	jpj
晕	jpl
蜿	jpq
晏	jpv
蛇	jpx
㬕	jpy
昂	jqb
蟾	jqd
晁	jqi
晚	jqk
易	jqr
歇	jqw
蝬	jrb
䖰	jre
蝗	jrg
昕	jrh
蛛	jri
蟱	jrl
螝	jrq
颗	jsd
晒	jsg
虰	jsh
果	jsi
蚵	jsk
晰	jsr
杲	jsu
蚞	jsy
蜂	jtd
星	jtg
昨	jth
晌	jtm
蟋	jto
蛾	jtr
蝌	jtu
晦	jtx
临	jty
觉	jue
昱	juf
曦	jug
暗	juj
蜕	juk
蝉	jul
均	jun
螊	juv
旯	jvb
妟	jvf
归	jvg
照	jvk
均	jvn
虭	jvt
蚣	jwc
蛤	jwg
螩	jwh
㬰	jwi
蛻	jwk
虮	jwn
蚥	jwr
蛜	jwv
䘋	jww
晔	jwx
晗	jwy
㫐	jxb
曳	jxe
䗰	jxf
蠅	jxg
蚓	jxh
曏	jxt
昆	jxx
曵	jxy
蛀	jyg
影	jyk
蝙	jyn
蚁	jyr
昉	jyt
旻	jyu
螂	jyv
蛟	jyw
蟀	jyx
蚊	jyy
嘶	kad
叿	kag
呀	kah
开	kai
噶	kaj
嘞	kak
呓	kan
考	kao
唠	kap
哎	kar
哄	kaw
嗫	kbc
咠	kbf
吇	kbg
叩	kbh
咄	kbm
吼	kbn
啊	kbs
吸	kby
邑	kcb
嗓	kcc
嗵	kce
吗	kcg
吧	kcn
嗎	kco
吮	kcq
唉	kct
唆	kcw
叹	kcy
呃	kdb
吰	kdc
咕	kdg
嘎	kdh
喱	kdj
顺	kdm
嘹	kdu
咙	kdx
吠	kdy
肙	kef
咀	keg
嗖	keh
剋	kei
别	kej
咖	kek
嚼	kel
肯	ken
嗳	kep
鹃	keq
另	ker
叻	ket
哸	kev
喷	kfa
吱	kfc
哇	kff
吐	kfg
叶	kfh
味	kfi
嘲	kfj
嘻	kfk
鄙	kfl
喃	kfm
嗦	kfp
嗜	kft
吋	kfy
吨	kgb
吴	kgd
哺	kge
呈	kgf
㕶	kgg
吓	kgh
哽	kgj
嗽	kgk
嘈	kgm
号	kgn
哑	kgo
逞	kgp
咧	kgq
咦	kgx
距	kha
踊	khc
跨	khd
踩	khe
践	khf
贵	khg
趾	khh
踏	khi
踢	khj
中	khk
盅	khl
蹦	khm
忠	khn
踱	kho
踪	khp
跑	khq
跌	khr
跃	kht
足	khu
跟	khv
趴	khw
嘴	khx
卟	khy
哨	kie
咣	kig
啵	kih
唢	kim
吵	kit
哩	kjf
呻	kjh
唱	kjj
嗢	kjl
喁	kjm
喝	kjq
虽	kju
骂	kkc
器	kkd
吕	kkf
吅	kkg
串	kkh
品	kkk
咒	kkw
咽	kld
喟	kle
嘿	klf
喂	klg
呷	klh
嚃	kli
嘪	klm
啰	klq
嗣	kma
郧	kmb
喘	kmd
勋	kme
哃	kmg
吊	kmh
嘤	kmm
员	kmu
呐	kmw
㗀	kmx
呗	kmy
哪	kng
叫	knh
噼	knk
唰	knm
嘱	knt
呢	knx
吣	kny
噗	kog
㖢	koh
空	kon
啖	koo
噒	koq
嘛	kos
口	kou
喽	kov
咪	koy
噻	kpa
哝	kpe
喧	kpg
嘧	kpn
啘	kpq
咛	kps
喀	kpt
咹	kpv
嚓	kpw
咜	kpx
兄	kqb
啗	kqe
噜	kqg
唤	kqm
呜	kqn
嚕	kqo
哆	kqq
吻	kqr
吹	kqw
鸣	kqy
唣	kra
呱	krc
唏	krd
㕷	krg
听	krh
史	kri
嘸	krl
啪	krr
啤	krt
啦	kru
喞	krx
嘌	ksf
哂	ksg
叮	ksh
喳	ksj
呵	ksk
㘄	ksl
噤	kss
呆	ksu
喓	ksv
㕲	ksy
噬	kta
唾	ktf
咱	kth
咯	ktk
响	ktm
吃	ktn
啾	kto
哦	ktr
呼	ktu
呚	kty
跨	kua
嗍	kub
咲	kud
唴	kuf
嗟	kug
吖	kuh
亏	kui
噫	kuj
困	kun
阔	kuo
嚪	kuq
嗞	kux
噚	kva
唧	kvc
㖀	kvg
嚍	kvh
啸	kvi
㕤	kvn
嘨	kvo
唚	kvp
叧	kvr
叨	kvt
䬭	kvw
呛	kwb
嗡	kwc
啥	kwf
哈	kwg
叽	kwn
嗲	kwr
咻	kws
只	kwu
吩	kwv
哗	kwx
叭	kwy
呦	kxe
喙	kxg
吲	kxh
咈	kxj
㖰	kxm
叱	kxn
哟	kxq
哔	kxx
吆	kxy
唷	kyc
唁	kyg
嚷	kyk
咳	kyn
㕫	kyt
啼	kyu
啷	kyv
吭	kyw
呅	kyy
轼	laa
轞	lah
来	lai
羃	laj
㘟	lak
蓝	lan
老	lao
轥	lau
輙	lbc
囝	lbd
辄	lbn
轻	lca
轰	lcc
囜	lci
轭	ldb
固	ldd
囿	lde
罟	ldf
轱	ldg
罘	ldh
因	ldi
恩	ldn
畸	lds
畴	ldt
軑	ldy
㘞	lee
胃	lef
䢁	leg
累	lei
冷	len
男	ler
䡃	let
罢	lfc
畦	lff
轩	lfh
団	lfi
䍐	lfj
辕	lfk
转	lfn
黑	lfo
园	lfq
署	lft
囤	lgb
囯	lgd
辅	lge
軖	lgg
罡	lgh
辐	lgk
辆	lgm
车	lgn
国	lgy
罪	lhd
罩	lhj
㐃	lhk
甲	lhn
列	lie
輄	lig
囦	lii
林	lin
㱎	liq
軣	liu
䳴	liw
輵	ljq
輠	ljs
辊	ljx
辑	lkb
回	lkd
軎	lkf
甽	lkh
圆	lkm
䍛	lld
畕	llf
圜	llg
䡛	llh
㘡	llk
田	lll
罳	lln
轋	llp
軮	lmd
輖	lmf
轴	lmg
軕	lmh
買	lmu
鷶	lmw
辗	lna
轏	lnb
翈	lng
轧	lnn
思	lnu
辘	lon
辚	loq
䍘	lou
辖	lpd
连	lpk
蜀	lqj
逻	lqp
囫	lqr
罗	lqu
软	lqw
鸭	lqy
䍟	lrb
畈	lrc
堑	lrf
斩	lrh
暂	lrj
䍢	lrl
錾	lrq
㜞	lrv
轶	lrw
町	lsh
困	lsi
甼	lsj
轲	lsk
䍒	lsu
轿	ltd
囷	lti
略	ltk
图	ltu
畋	lty
圈	lud
略	lue
畔	lug
轮	lun
落	luo
図	lur
㽧	lux
䣚	lvb
囡	lvd
略	lve
㚻	lvf
轈	lvj
轺	lvk
辎	lvl
轨	lvn
輑	lvt
鷜	lvw
軗	lwc
输	lwg
囚	lwi
界	lwj
䡄	lwn
轮	lwx
㽗	lwy
䡏	lxc
羄	lxh
累	lxi
毗	lxx
辙	lyc
圁	lyd
詈	lyf
罚	lyj
䍦	lyr
较	lyw
曲	mad
嵌	maf
屸	mag
买	mai
刪	maj
冊	mak
满	man
毛	mao
嵘	map
岖	mar
典	maw
戝	may
㕀	mbb
㞨	mbg
邮	mbh
崡	mbi
貤	mbn
㞧	mbr
屷	mbt
岌	mby
岜	mcb
嵾	mcc
㟥	mcd
峄	mcg
禸	mci
贻	mck
峻	mcw
贿	mde
岩	mdf
岵	mdg
央	mdi
崦	mdj
盎	mdl
炭	mdo
鸯	mdq
屵	mdr
崎	mds
贆	mdy
髓	med
崩	mee
骨	mef
岄	meg
骳	meh
没	mei
髑	mel
们	men
髅	meo
髋	mep
屴	mer
骼	met
崢	mev
骰	mew
骸	mey
岐	mfc
冉	mfd
峙	mff
赋	mfh
雕	mfk
赎	mfn
财	mft
贱	mfx
赙	mge
同	mgk
屿	mgn
峡	mgu
岥	mhc
帏	mhf
幅	mhg
帖	mhh
帽	mhj
巾	mhk
帼	mhl
冂	mhn
帕	mhr
帐	mht
幢	mhu
帆	mhw
峭	mie
埊	mif
崉	mij
䞆	mim
民	min
贘	mip
汖	miu
㞱	mjf
则	mjh
嵎	mjm
赐	mjq
岿	mjv
嶯	mkb
冋	mkd
㞻	mkg
㞲	mkh
巖	mkk
迥	mkp
贶	mkq
㟕	mku
嶉	mkw
崮	mld
嶧	mlf
岬	mlh
㠥	mll
崽	mln
崭	mlr
㟺	mlv
峀	mmf
册	mmg
屾	mmh
岀	mmj
山	mmm
岗	mmr
婴	mmv
賏	mmy
岷	mna
岂	mnb
嵋	mnh
㠔	mnk
觊	mnm
屺	mnn
囘	mnv
凯	mnw
㞾	mnx
赃	mof
嶪	mog
嶙	moq
某	mou
嵝	mov
迪	mpd
崇	mpf
贮	mpg
䢙	mpi
辿	mpk
賱	mpl
貯	mps
㞫	mpu
峖	mpv
岮	mpx
见	mqb
购	mqc
赡	mqd
崟	mqf
崯	mqg
峋	mqj
岣	mqk
岁	mqu
峥	mqv
贩	mrc
岶	mrg
岓	mrh
冈	mri
刚	mrj
嵬	mrq
网	mrr
㠒	msf
贉	msj
岢	msk
崊	mss
崾	msv
嵀	msy
账	mta
峰	mtd
赂	mtk
屹	mtn
贬	mtp
峨	mtr
巍	mtv
败	mty
岦	muf
嵯	mug
嶂	muj
赔	muk
赠	mul
剛	mum
赚	muv
嵫	mux
罔	muy
峎	mve
峍	mvg
贐	mvh
㟤	mvi
岧	mvk
崰	mvl
屶	mvr
峮	mvt
赊	mwf
内	mwi
囧	mwm
㞦	mwn
岚	mwr
㞤	mwu
肉	mww
岭	mwy
巓	mxh
嵹	mxk
幽	mxx
㟂	mxy
丹	myd
彤	mye
訔	myf
嵩	myk
赅	myn
崺	myt
㞵	myu
䝮	myx
㞶	myy
展	nae
羾	nag
奶	nai
异	naj
懵	nal
屉	nan
闹	nao
懂	nat
民	nav
殿	naw
慌	nay
孱	nbb
慑	nbc
㞌	nbd
邔	nbh
屈	nbm
忚	nbn
敢	nbt
惙	ncc
惨	ncd
怪	ncf
㞋	nci
怡	nck
㞎	ncv
惰	nda
居	ndd
懮	nde
怙	ndg
怀	ndh
剧	ndj
怖	ndm
忧	ndn
恢	ndo
忕	ndy
内	nei
嫩	nen
忇	net
愤	nfa
层	nfc
懦	nfd
恃	nff
慎	nfh
慰	nfi
卂	nfk
迅	nfp
屠	nft
导	nfu
忖	nfy
那	ngb
屋	ngc
刁	ngd
情	nge
䍿	ngf
忹	ngg
怔	ngh
恒	ngj
司	ngk
怦	ngu
愫	ngx
眉	nhd
胥	nhe
丑	nhf
疋	nhi
蛋	nhj
丩	nhk
收	nht
惧	nhw
疏	nhy
屑	nie
恍	nig
尿	nii
䎓	nij
您	nin
犀	nit
牛	niu
悍	njf
慢	njl
㦙	njm
惕	njq
惺	njt
惃	njx
憬	njy
吢	nkf
忡	nkh
愕	nkk
屌	nkm
悞	nkn
壁	nku
翼	nla
屇	nld
怬	nlg
恛	nlk
翴	nlp
惭	nlr
悃	nls
屢	nlv
㦬	nlx
愣	nly
届	nmd
惆	nmf
恫	nmg
刷	nmh
屃	nmi
恻	nmj
恺	nmn
惘	nmu
巽	nna
己	nng
书	nnh
局	nnk
乙	nnl
忆	nnn
忌	nnu
乜	nnv
快	nnw
羽	nny
㦠	nog
惦	noh
屎	noi
弄	non
戂	nos
耨	nou
慷	nov
迉	npe
悺	nph
慏	npj
恽	npl
惋	npq
㤖	nps
懈	nqe
惍	nqg
恌	nqi
恂	nqj
愌	nqm
恀	nqq
惚	nqr
習	nrf
怕	nrg
忻	nrh
忾	nrn
愧	nrq
㦡	nrx
恓	nsg
忊	nsh
杘	nsi
憛	nsj
憟	nso
憷	nss
怵	nsy
怅	nta
悸	ntb
发	ntc
恬	ntd
必	nte
尾	ntf
性	ntg
虱	ntj
属	ntk
恤	ntl
懊	ntm
履	ntt
悔	ntx
改	nty
屏	nua
习	nud
虐	nue
翌	nuf
翋	nug
飞	nui
悦	nuk
憎	nul
黁	nun
娜	nuo
悌	nux
悯	nuy
慨	nvc
恨	nve
忰	nvf
妀	nvg
䎑	nvi
舝	nvp
忉	nvt
尻	nvv
怆	nwb
忪	nwc
戮	nwe
恰	nwg
夬	nwi
刔	nwj
凥	nwv
怜	nwy
惯	nxf
憴	nxg
愼	nxh
尼	nxv
屁	nxx
尺	nyi
昼	nyj
惊	nyk
忙	nyn
迟	nyp
恼	nyr
㤃	nyt
尽	nyu
翠	nyw
忟	nyy
度	oac
煤	oaf
灴	oag
㡲	oai
灷	oaj
廑	oak
席	oam
炼	oan
遮	oao
烧	oat
粪	oaw
㸎	obb
籽	obg
邝	obh
灺	obn
廕	obw
烃	oca
糝	occ
糁	ocd
広	oci
粑	ocn
㶼	oct
糊	ode
炻	odg
庆	odi
庵	odj
烦	odm
类	odu
庞	odx
粗	oeg
燰	oep
庄	ofd
灶	ofg
籵	ofh
炜	ofn
烤	oft
籿	ofy
炖	ogb
业	ogd
精	oge
炡	ogh
粳	ogj
糟	ogm
凿	ogu
粘	ohk
应	oig
爣	oip
炒	oit
爆	oja
焊	ojf
灲	ojh
熳	ojl
庽	ojm
烛	ojy
燥	okk
熉	okm
炾	okq
炽	okw
烟	old
畨	olf
畑	olg
炠	olh
库	olk
庙	omd
粙	omg
灿	omh
炯	omk
粣	omm
煱	omn
㷨	omt
㐘	onb
応	oni
鹿	onj
㢞	onl
焗	onn
断	onr
废	ont
廖	onw
烬	ony
廘	oon
火	ooo
炎	oou
糖	oov
炏	ooy
烷	opf
煊	opg
迷	opi
熐	opj
熔	opw
底	oqa
灮	oqb
燃	oqd
焰	oqe
㶷	oqj
䊅	oqk
焕	oqm
炮	oqn
炊	oqw
灼	oqy
糉	orb
粄	orc
烯	ord
粕	org
炘	orh
庍	ork
熂	orn
廆	orq
䊛	ors
燩	ory
粞	osg
灯	osh
床	osi
庁	osk
麻	oss
炑	osy
烽	otd
糙	otf
炸	oth
烙	otk
熜	otl
烁	otn
㸅	otv
敉	oty
烂	oud
料	ouf
粒	oug
熾	ouj
焙	ouk
熷	oul
焖	oun
廉	ouv
㶢	ovb
庸	ove
娄	ovf
籹	ovg
唐	ovh
康	ovi
炤	ovk
爉	ovl
数	ovt
庚	ovw
炝	owb
炂	owc
煅	owd
腐	owf
庂	owi
籶	own
庥	ows
粉	owv
座	oww
焓	owy
廎	oxd
㶭	oxe
粌	oxh
糨	oxk
庀	oxv
庇	oxx
焴	oyc
㢇	oyd
广	oyg
廓	oyk
廪	oyl
炉	oyn
米	oyt
熵	oyu
粮	oyv
粹	oyw
炫	oyx
炆	oyy
宦	pah
拍	pai
寞	paj
宽	pam
盘	pan
跑	pao
赛	paw
冣	pbc
字	pbf
㝋	pbj
㝊	pcu
宏	pdc
寡	pde
宕	pdf
割	pdh
寄	pds
宠	pdx
肎	pef
宜	peg
农	pei
喷	pen
宗	pfi
完	pfq
守	pfu
室	pgc
家	pge
宇	pgf
定	pgh
宣	pgj
富	pgk
寅	pgm
写	pgn
宝	pgy
寂	phg
官	phn
㓀	phu
宵	pie
品	pin
㲾	piu
寖	piv
幂	pjd
审	pjh
寓	pjm
宴	pjv
冥	pjy
宺	pkg
宫	pkk
郓	plb
寰	plg
皲	plh
军	plj
宙	pmf
冚	pmj
㝕	pnc
甯	pne
寐	pnh
寜	pnl
賔	pnm
蜜	pnt
寥	pnw
廴	pny
灾	pou
之	ppp
㝎	ppu
宛	pqb
⺳	pqd
冤	pqk
寏	pqm
鸩	pqq
冘	pqv
鴆	pqw
寙	prc
宾	prg
宁	psj
宋	psu
宅	pta
宪	ptf
牢	ptg
㝚	pth
额	ptk
衩	puc
实	pud
衫	pue
衬	puf
袜	pug
被	puh
裆	pui
裸	puj
袖	pum
褶	pun
裤	puo
袍	puq
裨	pur
襟	pus
袄	put
初	puv
裕	puw
宄	pvb
安	pvf
案	pvs
穿	pwa
冗	pwb
突	pwd
穷	pwe
察	pwf
窒	pwg
窠	pwj
窝	pwk
帘	pwm
窟	pwn
窕	pwq
窑	pwr
窗	pwt
穴	pwu
究	pwv
容	pww
穹	pwx
鹤	pwy
它	pxb
宖	pxc
䙾	pxh
迱	pxp
祺	pya
祁	pyb
祷	pyd
祖	pye
社	pyf
福	pyg
神	pyj
祝	pyk
视	pym
礼	pyn
祗	pyq
祈	pyr
祚	pyt
祥	pyu
禄	pyv
钳	qaf
釭	qag
昏	qaj
锚	qal
钜	qan
铹	qap
铙	qat
氏	qav
镬	qaw
邸	qay
镊	qbc
铒	qbg
钌	qbh
鐊	qbj
锰	qbl
怨	qbn
迎	qbp
鸳	qbq
釢	qbt
色	qcb
铎	qcg
勾	qci
䥁	qcl
钯	qcn
钗	qcy
危	qdb
钴	qdg
锲	qdh
厃	qdr
铸	qdt
镣	qdu
詹	qdw
銭	qdx
然	qdy
臽	qef
钥	qeg
角	qeh
鉫	qek
钐	qet
勻	qfd
钍	qfg
针	qfh
镭	qfl
鋕	qfn
锗	qft
钱	qfx
钝	qgb
鱿	qgd
铺	qge
鱼	qgf
钙	qgh
鲁	qgj
鳄	qgk
鳃	qgl
鳞	qgo
鲩	qgp
鲍	qgq
鳔	qgs
鲜	qgu
鲫	qgv
鲋	qgw
鲸	qgy
䀏	qhd
钼	qhg
亇	qhj
钻	qhk
外	qhy
掐	qia
销	qie
玺	qig
覙	qih
兆	qii
锁	qim
亲	qin
逃	qip
钞	qit
尔	qiu
铛	qiv
釥	qiy
郇	qjb
铿	qjc
旬	qjd
锂	qjf
鈤	qjg
钊	qjh
鎤	qji
镘	qjl
龟	qjn
锡	qjq
锞	qjs
锟	qjx
鉵	qjy
句	qkd
象	qke
名	qkf
釦	qkg
钏	qkh
铝	qkk
锅	qkm
够	qkq
䥯	qlc
甸	qld
钿	qlg
钾	qlh
鑸	qll
锶	qln
链	qlp
锣	qlq
鏤	qlv
镙	qlx
铀	qmg
铡	qmj
铠	qmn
钢	qmr
负	qmu
钠	qmw
钡	qmy
饶	qna
饣	qnb
饴	qnc
锯	qnd
馁	qne
饯	qnf
乌	qng
钮	qnh
蚀	qnj
馈	qnk
钆	qnn
馆	qnp
饮	qnq
饭	qnr
饰	qnt
饼	qnu
包	qnv
饥	qnw
饺	qny
镀	qoa
鱊	qoc
镤	qog
鱸	qoh
匊	qoi
魯	qoj
鱢	qok
鰱	qol
鯛	qom
鰾	qos
炙	qou
镂	qov
鮨	qox
钬	qoy
鑳	qpa
鋐	qpd
锭	qpg
鍕	qpl
鑏	qpn
䤹	qpo
铵	qpv
铊	qpx
钩	qqc
鍂	qqg
匇	qqi
铭	qqk
钨	qqn
金	qqq
铆	qqt
多	qqu
铮	qqv
钦	qqw
钓	qqy
匈	qrb
勿	qre
铂	qrg
釿	qrh
匁	qri
刎	qrj
锦	qrm
忽	qrn
锨	qrq
铁	qrw
匆	qry
镖	qsf
钵	qsg
钉	qsh
钶	qsk
錰	qso
鑻	qsr
鈢	qsy
猎	qta
犯	qtb
锋	qtd
狙	qte
猪	qtf
狂	qtg
镍	qth
独	qtj
铬	qtk
猬	qtl
猾	qtm
儿	qtn
狄	qto
狞	qtp
狗	qtq
狐	qtr
狠	qtv
猴	qtw
狒	qtx
狼	qty
匀	qud
却	que
锌	quf
镁	qug
镜	quj
锐	quk
䥕	qum
钔	qun
锵	quq
铲	qut
鎌	quv
锑	qux
邹	qvb
匓	qvc
银	qve
刍	qvf
钕	qvg
争	qvh
锱	qvl
鎻	qvm
急	qvn
煞	qvt
勼	qvv
雏	qvw
鈆	qwc
锻	qwd
勽	qwi
铅	qwk
釠	qwn
欠	qwu
鵭	qwv
锉	qww
铃	qwy
鐑	qxf
錄	qxg
鈏	qxh
镄	qxj
匂	qxv
鉧	qxy
铳	qyc
訇	qyd
铱	qye
䚻	qyf
勺	qyi
镶	qyk
鸟	qyn
灸	qyo
钫	qyt
镑	qyu
留	qyv
铰	qyw
鈫	qyy
拭	raa
皂	rab
撕	rad
撒	rae
扛	rag
措	raj
描	ral
拒	ran
绕	rao
捞	rap
抠	rar
挠	rat
搭	raw
找	ray
报	rbc
挕	rbg
邤	rbh
拯	rbi
凶	rbk
拙	rbm
扡	rbn
扔	rbt
拚	rca
掇	rcc
掺	rcd
捅	rce
择	rcg
反	rci
抬	rck
把	rcn
返	rcp
挨	rct
㿝	rcu
摊	rcw
瓜	rcy
扼	rdb
拔	rdc
肴	rde
振	rdf
拓	rdg
掩	rdj
希	rdm
扰	rdn
挞	rdp
撩	rdu
捧	rdw
拢	rdx
扙	rdy
援	reg
拥	reh
人	ren
授	rep
摇	rer
扐	ret
技	rfc
持	rff
扗	rfg
盾	rfh
皁	rfj
拮	rfk
擂	rfl
质	rfm
挝	rfp
抚	rfq
拷	rft
扶	rfw
邱	rgb
丘	rgd
搏	rge
皇	rgf
抂	rgg
后	rgk
岳	rgm
遑	rgp
抹	rgs
乒	rgt
挟	rgu
捷	rgv
兵	rgw
乓	rgy
掳	rha
卸	rhb
披	rhc
排	rhd
看	rhf
扯	rhg
攫	rhh
掉	rhj
拈	rhk
扑	rhy
捎	rie
朱	rii
搅	rip
抄	rit
泉	riu
挡	riv
撮	rjb
捏	rjf
担	rjg
刈	rjh
揭	rjq
揽	rjt
拽	rjx
揖	rkb
挹	rkc
拐	rke
扣	rkg
捉	rkh
操	rkk
损	rkm
摁	rld
摆	rlf
舞	rlg
押	rlh
捆	rls
撂	rlt
摞	rlx
罐	rma
揣	rmd
抽	rmg
制	rmh
罎	rmj
缶	rmk
撄	rmm
缺	rmn
摧	rmw
抿	rna
气	rnb
氢	rnc
据	rnd
握	rng
扭	rnh
氤	rnl
氙	rnm
扎	rnn
氮	rno
氨	rnp
所	rnr
拨	rnt
氧	rnu
氯	rnv
氛	rnw
氟	rnx
拟	rny
拡	roc
撲	rog
掂	roh
容	ron
扩	rot
肉	rou
搂	rov
迫	rpd
皖	rpf
近	rpk
挥	rpl
摈	rpr
拧	rps
按	rpv
控	rpw
拕	rpx
抵	rqa
抑	rqb
鬼	rqc
掐	rqe
捦	rqg
挑	rqi
挽	rqk
换	rqm
抱	rqn
掬	rqo
掏	rqr
挣	rqv
欣	rqw
的	rqy
扳	rrc
拍	rrg
折	rrh
蜇	rrj
哲	rrk
逝	rrp
掀	rrq
白	rrr
捭	rrt
爻	rru
拆	rry
弑	rsa
拪	rsg
打	rsh
刹	rsj
杀	rsu
托	rta
拖	rtb
括	rtd
搬	rte
插	rtf
手	rtg
攥	rth
播	rto
斤	rtt
乂	rty
拼	rua
拦	rud
抖	ruf
拉	rug
瑞	rui
撞	ruj
掸	rul
撇	rum
扪	run
若	ruo
搁	rut
接	ruv
抛	rve
扫	rvg
招	rvk
殷	rvn
㧅	rvt
势	rvy
抢	rwb
投	rwc
拾	rwg
失	rwi
迭	rwp
㒵	rwu
扮	rwv
挫	rww
抡	rwx
扒	rwy
皀	rxb
拗	rxe
指	rxj
㨥	rxm
㧈	rxn
批	rxx
拇	rxy
撤	ryc
拄	ryg
斥	ryi
挤	ryj
搞	ryk
擅	ryl
护	ryn
邀	ryt
摘	ryu
抗	ryw
摔	ryx
抆	ryy
械	saa
栉	sab
棋	sad
柑	saf
杠	sag
栋	sai
模	saj
横	sam
柜	san
扫	sao
檬	sap
枢	sar
椰	sbb
椭	sbd
李	sbf
栮	sbg
邒	sbh
杝	sbn
㭁	sbt
极	sby
槮	scc
桶	sce
树	scf
杷	scn
榪	sco
梭	scw
权	scy
柭	sdc
㰁	sdd
枯	sdg
杯	sdh
顶	sdm
椅	sds
梆	sdt
䙲	sdu
棒	sdw
杖	sdy
棚	see
桕	seg
枷	sek
森	sen
杉	set
橳	seu
枝	sfc
桂	sff
杜	sfg
杆	sfh
票	sfi
桔	sfk
楠	sfm
材	sft
棱	sfw
栈	sfx
村	sfy
醋	sga
酸	sgc
酉	sgd
酹	sge
酵	sgf
枉	sgg
丁	sgh
醒	sgj
梧	sgk
槽	sgm
配	sgn
醚	sgo
酌	sgq
酗	sgr
酊	sgs
酷	sgt
酚	sgw
酯	sgx
醉	sgy
啥	sha
舍	she
相	shg
是	shi
想	shn
手	sho
书	shu
朴	shy
梢	sie
档	siv
㭂	siy
杳	sjf
查	sjg
柛	sjh
榻	sjn
棵	sjs
槛	sjt
棍	sjx
楫	skb
可	skd
柺	ske
杏	skf
杊	skh
哥	sks
棝	sld
㭗	slf
柶	slg
柙	slh
櫑	sll
楒	sln
椤	slq
樓	slv
楐	slw
欏	slx
楞	sly
椯	smd
柚	smg
杣	smh
栅	smm
枧	smq
㭎	smr
贾	smu
梖	smy
朰	snb
栩	sng
楣	snh
樨	sni
札	snn
杨	snr
杺	sny
桩	sof
送	son
橉	soq
㯅	sor
粟	sou
楼	sov
迺	spd
棕	spf
棺	sph
榠	spj
枕	spq
槟	spr
柠	sps
桉	spv
榷	spw
构	sqc
桅	sqd
桃	sqi
橡	sqk
櫓	sqo
楤	sqr
柳	sqt
榴	sqy
板	src
柏	srg
析	srh
株	sri
蜤	srj
棉	srm
槐	srq
攀	srr
檄	sry
郴	ssb
彬	sse
禁	ssf
栖	ssg
朾	ssh
柯	ssk
楚	ssn
焚	sso
梦	ssq
森	sss
栗	ssu
婪	ssv
梵	ssw
林	ssy
桥	std
橇	stf
柞	sth
格	stk
榭	stm
楸	sto
覆	stt
䅇	stu
梅	stx
枚	sty
栏	sud
样	sug
岁	sui
樟	suj
孙	sun
所	suo
梯	sux
概	svc
根	sve
要	svf
棣	svi
朹	svn
棂	svo
朷	svt
枪	swb
松	swc
检	swg
机	swn
枫	swr
桦	swx
椎	swy
㯑	sxd
柪	sxe
樌	sxf
椽	sxg
槇	sxh
栺	sxj
朼	sxn
檰	sxr
楷	sxx
栂	sxy
梳	syc
柱	syg
术	syi
槁	syk
檀	syl
柿	sym
核	syn
述	syp
枋	syt
榜	syu
榔	syv
校	syw
箕	tad
笁	taf
筐	tag
太	tai
升	tak
簧	tam
谈	tan
套	tao
䇝	tau
乇	tav
筑	taw
长	tay
竾	tbb
箃	tbc
頺	tbd
季	tbf
秄	tbg
䄦	tbh
牠	tbn
透	tbp
秀	tbr
䄧	tbt
径	tca
笆	tcb
笃	tcg
笞	tck
㸭	tcn
么	tcu
私	tcy
甜	tda
舌	tdd
䇢	tdf
牯	tdg
逢	tdh
夭	tdi
乔	tdj
智	tdk
乱	tdn
适	tdp
舐	tdq
敌	tdt
矢	tdu
雉	tdw
笼	tdx
㣕	tdy
稻	tee
租	teg
舟	tei
笳	tek
盘	tel
舰	tem
疼	ten
舵	tep
务	ter
艇	tet
般	tew
航	tey
垂	tfa
丢	tfc
壬	tfd
竺	tff
牡	tfg
秆	tfh
午	tfj
千	tfk
德	tfl
毛	tfn
廷	tfp
先	tfq
乖	tfu
笺	tfx
生	tgd
竽	tgf
彺	tgg
征	tgh
重	tgj
牛	tgk
熏	tgl
策	tgm
行	tgs
秤	tgu
秉	tgv
算	tha
彼	thc
自	thd
怎	thf
片	thg
徙	thh
处	thi
昝	thj
咎	thk
鼻	thl
息	thn
延	thp
竹	tht
箈	tic
稍	tie
簿	tig
徜	tim
听	tin
箔	tir
秒	tit
尓	tiu
䈃	tiv
香	tjf
得	tjg
利	tjh
梨	tjs
复	tjt
䖝	tju
各	tkf
和	tkg
种	tkh
禹	tkm
积	tkw
血	tld
备	tlf
牭	tlg
笚	tlj
徊	tlk
惫	tln
粤	tlo
箩	tlq
衅	tlu
稷	tlw
身	tmd
笛	tmf
微	tmg
币	tmh
屲	tmj
向	tmk
奥	tmo
秽	tmq
筫	tmu
㸽	tmy
乞	tnb
徦	tnh
乐	tni
筷	tnn
迄	tnp
秘	tnt
释	toc
釆	toi
翻	tol
釉	tom
愁	ton
醔	tos
夈	tou
篓	tov
秋	toy
稼	tpg
管	tph
乏	tpu
禿	tqb
衡	tqd
衔	tqg
称	tqi
徇	tqj
移	tqq
物	tqr
黎	tqt
稳	tqv
䆋	tqx
箍	tra
稀	trd
循	trf
徨	trg
御	trh
穆	tri
稗	trt
秩	trw
我	trx
徼	try
䇴	tsf
牺	tsg
箱	tsh
䈾	tsi
䉘	tsp
条	tsu
笑	ttd
笔	ttf
牲	ttg
稪	ttj
禾	ttt
牧	tty
箭	tue
笠	tuf
腿	tui
简	tuj
税	tuk
吞	tun
拖	tuo
乊	tur
冬	tuu
乘	tux
很	tve
委	tvf
律	tvg
覣	tvh
箫	tvi
笤	tvk
逶	tvp
魏	tvr
笋	tvt
筏	twa
秃	twb
役	twc
颓	twd
符	twf
徐	twg
筱	twh
黏	twi
秂	twu
凢	twv
稚	twy
龜	txd
篆	txg
第	txh
系	txi
牝	txn
繁	txt
每	txu
秕	txx
牳	txy
䇾	tyf
往	tyg
入	tyi
稿	tyk
篇	tyn
籴	tyo
篱	tyr
牥	tyt
疘	uad
瓶	uag
冻	uai
并	uaj
迸	uap
剏	uav
瘩	uaw
䇅	uay
闻	ubd
疓	ube
兯	ubj
疗	ubk
瘾	ubq
痾	ubs
塑	ubt
痉	uca
瘮	ucc
痛	uce
冯	ucg
冶	uck
疤	ucv
瘫	ucw
卷	udb
闫	udd
兰	udf
减	udg
眷	udh
头	udi
阉	udj
疣	udn
送	udp
拳	udr
关	udu
券	udv
凑	udw
辫	udx
状	udy
閒	ued
疽	ueg
瘦	ueh
前	uej
瘸	uek
遂	uep
㒸	ueu
毅	uew
阖	ufc
㽵	ufd
闺	uff
壮	ufg
癫	ufh
疛	ufi
辛	ufj
斗	ufk
痣	ufn
羌	ufq
闭	uft
养	ufw
装	ufy
差	uga
闰	ugd
靖	uge
⺷	ugf
症	ugh
羊	ugj
半	ugk
盖	ugl
病	ugm
羞	ugn
羹	ugo
冽	ugq
叛	ugr
羲	ugt
善	ugu
姜	ugv
羚	ugw
疲	uhc
㾇	uhd
丫	uhk
門	uhn
疵	uhx
痟	uie
閖	uii
阔	uit
冰	uiy
间	ujd
音	ujf
闽	uji
瘟	ujl
意	ujn
竟	ujq
韶	ujv
部	ukb
问	ukd
咅	ukf
冲	ukh
剖	ukj
癌	ukk
总	ukn
况	ukq
郸	ulb
痼	uld
兽	ulg
瘝	uli
单	ulj
闸	ulk
端	umd
凋	umf
弊	umi
疝	umk
翊	ung
闷	uni
癖	unk
䇃	unn
疡	unr
㽶	unv
决	unw
普	uog
焛	uoi
痰	uoo
瘘	uov
竤	upd
䦡	uph
凕	upj
㽸	upq
奖	uqd
阎	uqe
将	uqf
癣	uqg
浆	uqi
阄	uqj
痪	uqm
酱	uqs
净	uqv
资	uqw
瘤	uqy
㽿	urc
㾷	urh
闎	uri
䦐	urk
痸	urm
痺	urt
閪	usd
尊	usg
㓅	ush
闲	usi
疔	usk
新	usr
亲	usu
疾	utd
产	ute
首	uth
痢	utj
阁	utk
疙	utn
疼	utu
閚	uud
痒	uug
瘴	uuj
阅	uuk
阐	uul
立	uuu
痕	uve
妾	uvf
妆	uvg
歉	uvo
阀	uwa
疮	uwb
疫	uwc
疹	uwe
痊	uwg
闪	uwi
疥	uwj
益	uwl
竌	uwn
疯	uwr
癈	uwx
冷	uwy
背	uxe
弟	uxh
冀	uxl
北	uxn
凝	uxt
疕	uxv
兹	uxx
誾	uyd
閍	uye
冫	uyg
门	uyh
闵	uyi
凉	uyk
凛	uyl
闹	uym
阂	uyn
丷	uyt
阆	uyv
瘁	uyw
嫟	vaa
媶	vab
媒	vaf
妅	vag
姬	vah
嫫	vaj
尋	vak
媌	val
媾	vam
姖	van
妪	var
娆	vat
㚤	vay
㜽	vbf
好	vbg
邚	vbh
她	vbn
奶	vbt
既	vca
即	vcb
努	vce
妈	vcg
始	vck
帑	vcm
怒	vcn
厹	vcu
弩	vcx
奴	vcy
妭	vdc
娠	vdf
姑	vdg
妦	vdh
㛪	vdj
嫄	vdr
㚑	vdu
嫍	vee
垦	vef
姐	veg
嫂	veh
艮	vei
嬹	vem
恳	ven
退	vep
妓	vfc
娃	vff
奸	vfh
妹	vfi
卆	vfj
嬉	vfk
婻	vfm
妩	vfq
孀	vfs
姥	vft
寻	vfu
妍	vga
姪	vgc
婊	vge
嫣	vgh
聿	vgk
娅	vgo
建	vgp
婕	vgv
姨	vgx
嫭	vha
㜹	vhh
婥	vhj
肀	vhk
媜	vhm
㚶	vhn
娊	vhq
隶	vii
肃	vij
盝	vil
逮	vip
妙	vit
录	viu
旭	vjd
旮	vjf
媢	vjh
娼	vjj
媪	vjl
媀	vjm
㛫	vjq
巢	vjs
婫	vjx
邵	vkb
娟	vke
召	vkf
如	vkg
娲	vkm
恕	vkn
迢	vkp
欩	vkq
絮	vkx
䣎	vlb
姻	vld
媦	vle
甾	vlf
㚼	vlg
嬽	vlh
㜥	vlm
媤	vln
邋	vlr
㜢	vlv
媏	vmd
妯	vmg
奾	vmh
㞪	vmj
姗	vmm
媧	vmn
妠	vmw
㛝	vmy
㐇	vnb
婮	vnd
娜	vng
婿	vnh
妃	vnn
刀	vnt
㣽	vnu
妮	vnx
粛	voj
婒	voo
嬷	vos
㚧	vot
灵	vou
彞	vox
辺	vpe
婃	vpf
嫁	vpg
婠	vph
婶	vpj
帚	vpm
㛮	vpo
婉	vpq
巡	vpv
婚	vqa
姚	vqi
娩	vqk
媍	vqm
㚿	vqn
夛	vqu
鸠	vqy
㛂	vrc
㛓	vrd
妡	vrh
姝	vri
嫵	vrl
婂	vrm
媿	vrq
婢	vrt
妷	vrw
㜰	vrx
嬓	vry
嫖	vsf
㛉	vsg
奵	vsh
㜁	vsj
妸	vsk
㛦	vss
杂	vsu
娇	vtd
尹	vte
妊	vtf
姓	vtg
媳	vth
群	vtk
媲	vtl
九	vtn
娥	vtr
姀	vty
姘	vua
婘	vud
媊	vue
㛙	vuf
嫜	vuj
婵	vul
娴	vus
嫉	vut
嫌	vuv
㜋	vuw
娣	vux
㚣	vvf
妇	vvg
嬧	vvh
女	vvv
妐	vwc
刅	vwi
㛋	vwn
㚯	vwr
妗	vwy
嬵	vxr
嫋	vxu
妣	vxx
姆	vxy
訄	vyd
娮	vyg
丸	vyi
婷	vyk
忍	vyn
妨	vyt
嫡	vyu
娘	vyv
姣	vyw
妶	vyx
妏	vyy
仝	waf
仜	wag
外	wai
借	waj
万	wan
儆	waq
侥	wat
供	waw
伐	way
仓	wbb
仔	wbg
䢳	wbh
创	wbj
他	wbn
仍	wbt
颂	wcd
俑	wce
瓮	wcg
凤	wci
翁	wcn
俟	wct
公	wcu
俊	wcw
仅	wcy
佐	wda
估	wdg
俺	wdj
佑	wdk
优	wdn
倚	wds
做	wdt
僚	wdu
段	wdw
伏	wdy
俘	web
䏌	wef
仴	weg
佣	weh
为	wei
伽	wek
问	wen
倪	weq
㐱	wer
仂	wet
会	wfc
儒	wfd
佳	wff
仁	wfg
什	wfh
祭	wfi
癷	wfj
舍	wfk
传	wfn
佬	wft
付	wfy
倒	wgc
癸	wgd
傅	wge
全	wgf
伍	wgg
剑	wgi
便	wgj
合	wgk
僵	wgl
俩	wgm
兮	wgn
俨	wgo
例	wgq
余	wgs
侠	wgu
凪	whd
企	whf
个	whj
侦	whm
候	whn
修	wht
俱	whw
仆	why
俏	wie
倘	wim
偿	wip
氽	wiu
仦	wiy
俚	wjf
但	wjg
伸	wjh
介	wjj
㖋	wjk
僈	wjl
偶	wjm
㕣	wkf
㐰	wkg
促	wkh
侣	wkk
保	wks
佃	wlg
俥	wlh
佪	wlk
儡	wll
偲	wln
僂	wlv
倜	wmf
侗	wmg
仙	wmh
侧	wmj
催	wmw
倔	wnb
伺	wng
假	wnh
僻	wnk
亿	wnn
侯	wnt
偋	wnu
亾	wnv
似	wny
儍	wob
㶡	woi
偻	wov
俯	wow
伙	woy
侬	wpe
倧	wpf
倌	wph
倇	wpq
侒	wpv
佗	wpx
低	wqa
仰	wqb
釡	wqf
你	wqi
像	wqk
侈	wqq
㐴	wqy
爷	wrb
爸	wrc
釜	wrf
伯	wrg
伒	wrh
风	wri
爹	wrq
斧	wrr
俾	wrt
父	wru
体	wsg
仃	wsh
凩	wsi
剁	wsj
何	wsk
僳	wso
傈	wss
朵	wsu
休	wsy
侨	wtd
伤	wte
任	wtf
件	wtg
作	wth
俐	wtj
傻	wtl
几	wtn
俄	wtr
倭	wtv
侮	wtx
八	wty
倦	wud
伞	wuf
位	wug
倍	wuk
僧	wul
们	wun
仒	wuu
颁	wvd
健	wvg
盆	wvl
贫	wvm
仇	wvn
侵	wvp
分	wvr
伊	wvt
耸	wwb
坐	wwf
丛	wwg
价	wwj
谷	wwk
仉	wwn
仌	wwu
份	wwv
众	www
伦	wwx
从	wwy
仑	wxb
倾	wxd
华	wxf
僶	wxg
伄	wxh
佛	wxj
货	wxm
化	wxn
偕	wxx
㑄	wxy
令	wyc
依	wye
储	wyf
信	wyg
凡	wyi
停	wyk
今	wyn
焦	wyo
仪	wyr
集	wys
仿	wyt
傍	wyu
食	wyv
伩	wyy
绒	xad
红	xag
练	xan
绕	xat
緅	xbc
弭	xbg
鄳	xbh
绌	xbm
弛	xbn
级	xby
经	xca
缀	xcc
绎	xcg
強	xcj
弝	xcn
弘	xcy
毋	xdd
绔	xdf
缄	xdg
紑	xdh
䋘	xdi
弼	xdj
顷	xdm
绮	xds
绑	xdt
缭	xdu
绷	xee
组	xeg
绶	xep
幼	xet
绥	xev
毌	xfd
疆	xfg
缜	xfh
结	xfk
贯	xfm
续	xfn
绪	xft
线	xfx
纣	xfy
纯	xgb
緻	xgc
彑	xgd
缚	xge
弖	xgf
绠	xgj
綀	xgk
缰	xgl
绩	xgm
彝	xgo
彙	xgp
紴	xhc
绯	xhd
䊼	xhg
引	xhh
缈	xhi
绰	xhj
弔	xhk
下	xia
写	xie
弾	xil
新	xin
纱	xit
糸	xiu
繓	xjb
旨	xjf
绅	xjh
弗	xjk
费	xjm
綶	xjs
缆	xjt
䭬	xjv
鴲	xjw
绲	xjx
缉	xkb
绢	xke
紃	xkh
绳	xkj
縜	xkm
织	xkw
细	xlg
繃	xme
绸	xmf
紬	xmg
㢫	xmh
䌹	xmk
缨	xmm
㢷	xmq
纲	xmr
纳	xmw
䋧	xnd
弓	xng
纠	xnh
幻	xnn
缪	xnw
絋	xoc
缠	xoj
继	xon
緂	xoo
繗	xoq
䌕	xos
纩	xot
缕	xov
粥	xox
䋛	xoy
综	xpf
绽	xpg
绾	xph
缤	xpr
缩	xpw
纸	xqa
绝	xqc
䋮	xqg
弥	xqi
绚	xqj
绉	xqv
约	xqy
弧	xrc
絈	xrg
紤	xrh
绵	xrm
缴	xry
缥	xsf
絤	xsg
糽	xsh
䋍	xsk
䌚	xso
䌁	xsv
䋱	xsw
䊾	xsy
张	xta
绣	xtb
疑	xtd
乡	xte
纤	xtf
络	xtk
匕	xtn
绦	xts
终	xtu
学	xue
绊	xug
弹	xul
㢼	xum
寻	xun
絘	xuq
緧	xus
弱	xux
絕	xvc
学	xve
绿	xvi
缫	xvj
绍	xvk
䊵	xvn
綅	xvp
㓜	xvt
纫	xvy
缎	xwd
绘	xwf
给	xwg
纷	xwv
纵	xww
纶	xwx
维	xwy
毕	xxf
丝	xxg
纼	xxh
比	xxn
皆	xxr
统	xyc
编	xyn
纺	xyt
缔	xyu
绞	xyw
弦	xyx
纹	xyy
试	yaa
诺	yad
谋	yaf
讧	yag
讶	yah
啀	yai
谟	yaj
谨	yak
谍	yan
要	yao
诬	yaw
谎	yay
讘	ybb
诹	ybc
斈	ybf
誀	ybg
邡	ybh
㓙	ybk
诎	ybm
訑	ybn
䚮	ybt
弃	yca
育	yce
译	ycg
诒	yck
谲	ycn
充	ycq
诂	ydg
诔	ydi
斋	ydm
诚	ydn
诙	ydo
彣	yee
诅	yeg
裔	yem
谣	yer
䚲	yet
衣	yeu
谀	yew
謑	yex
诗	yff
计	yfh
讲	yfj
诘	yfk
读	yfn
诸	yft
讨	yfy
主	ygd
请	yge
证	ygh
㪯	ygj
语	ygk
谏	ygl
评	ygu
谑	yha
詖	yhc
诽	yhd
让	yhg
卞	yhu
讣	yhy
氷	yii
因	yin
訬	yit
䚱	yiy
斉	yjf
刘	yjh
齐	yjj
谩	yjl
谒	yjq
课	yjs
蚉	yju
郭	ykb
哀	yke
吝	ykf
误	ykg
训	ykh
京	yki
襄	ykk
高	ykm
亮	ykp
识	ykw
畆	ylc
谓	yle
亩	ylf
訵	ylg
䛅	ylh
颤	ylk
諰	yln
謰	ylp
謱	ylv
谡	ylw
调	ymf
䛆	ymg
讪	ymh
讷	ymw
㐎	ynb
戾	ynd
户	yne
讯	ynf
诩	yng
盲	ynh
永	yni
启	ynk
遍	ynm
记	ynn
刻	ynt
忞	ynu
亡	ynv
雇	ynw
房	yny
孪	yob
变	yoc
奕	yod
蛮	yoj
峦	yom
恋	yon
谈	yoo
迹	yop
銮	yoq
挛	yor
亦	you
弯	yox
詸	yoy
這	ypd
谊	ype
这	ypi
诨	ypl
诧	ypt
诋	yqa
诡	yqd
谄	yqe
誂	yqi
询	yqj
谗	yqk
諊	yqo
誃	yqq
诌	yqv
离	yrb
䜣	yrh
义	yri
譕	yrl
亵	yrv
诉	yry
订	ysh
谭	ysj
诃	ysk
旗	yta
施	ytb
话	ytd
旅	yte
许	ytf
诞	yth
谢	ytm
旋	ytn
族	ytt
诿	ytv
诲	ytx
放	yty
月	yue
详	yug
说	yuk
商	yum
云	yun
谱	yuo
帝	yup
谚	yut
谦	yuv
谥	yuw
朗	yvc
良	yve
诏	yvk
訅	yvn
亢	ywb
设	ywc
诊	ywe
褒	ywk
讥	ywn
交	ywr
夜	ywt
六	ywu
卒	yww
论	ywx
认	ywy
詏	yxe
譝	yxg
訠	yxh
率	yxi
诣	yxj
畜	yxl
䚰	yxn
雍	yxt
玄	yxu
谐	yxx
玆	yxy
文	yyg
谅	yyk
该	yyn
议	yyr
访	yyt
谤	yyu
言	yyy
